$$$$$$$$$$$$$$$
$....*#&#.....$
$.###.###.###.$
$.##..##..##..$
$.............$
$...###...##..$
$...###.#.##..$
$.#..#..##..#.$
$.#..#..#...#.$
$...#.#.....#.$
$.............$
$###..###..###$
$..#...#....##$
$.....###.....$
$...@.#&#.....$
$$$$$$$$$$$$$$$