$$$$$$$$$$$$$$$
$....*#.#.....$
$.###.###.###.$
$.##..##..##..$
$.............$
$...###...##..$
$...###.#.##..$
$.#..#..##..#.$
$.#..#..#...#.$
$...#.#.....#.$
$.............$
$###..###..###$
$..#...#....##$
$.....###.....$
$...@.#.#.....$
$$$$$$$$$$$$$$$